Format (all boss names are CaSe InSensItive):
Name: valid prefixes (separated by comma)
 
Abyssal Sire: abyssal sire, sire

Alchemical Hydra: alchemical hydra, hydra

Barrows Brothers: barrows

Bryophyta: bryophyta, bryo

Callisto: callisto

Cerberus: cerb, cerberus

Chambers of Xeric: cox, chambers, chambers of xeric

Chambers of Xeric Challnge Mode: cm, cox cm, challenge mode

Chaos Elemental: ele, chaos ele, chaos elemental

Chaos Fanatic: fanatic, chaos fanatic

Commander Zilyana: sara, saradomin, zilyana, zilly

Corporeal Beast: corp

Crazy Archeologist: crazy arch, crazy archeologist

Dagannoth Prime: prime, dagannoth prime

Dagannoth Rex: rex, dagannoth rex

Dagannoth Supreme: supreme, dagannoth supreme

Deranged Archeologist: deranged, deranged arch, deranged archeologist

General Graardor: graardor, bandos

Giant Mole: mole

Grotesque Guardians: guardians, gg, grotesque, dusk, noon

Hespori: hespori

Kalphite Queen: kq, kalphite, kalphite queen

King Black Dragon: kbd, king black dragon

Kraken: kraken

Kree'arra: kree, arma, armadyl, kree'arra, kreearra, kree arra

K'ril Tsutsaroth: kril, k'ril, zammy, zamorak, kril tsutsaroth

Mimic: mimic

The Nightmare: nightmare

Obor: obor

Sarachnis: sarachnis

Scorpia: scorpia

Skotizo: skotizo

Tempoross: temp, tempoross

The Gauntlet: gauntlet, hunllef

Corrupted Gauntlet: corr gauntlet, corr, corr hunllef, corrupted gauntlet

Theatre of Blood: tob, theatre, theatre of blood 

Thermonuclear Smokedevil: thermonuclear, thermy, thermonuclear smoke devil

TzKal-Zuk: zuk, inferno

TzTok-Jad: jad, fight caves

Venenatis: vene, venenatis

Vetion: vetion

Vorkath: vork, vorkath

Wintertodt: wintertodt, wt

Zalcano: zalc, zalcano

Zulrah: zulrah